1,1,5,3,5,1,3,4,1,
5,3,3,1,11,1,3,3,4,
4,2,3,1,12,3,2,6,3,
2,3,5,3,4,3,1,5,4,
6,2,3,10,1,5,3,5,4,
2,6,3,2,5,3,5,3,5,
5,5,4,6,2,6,6,3,4,
1,1,3,6,5,5,4,1,3,
4,1,4,4,6,2,4,4,2
