1,1,5,3,12,1,3,4,1,
5,3,3,1,2,1,3,3,4,
4,2,11,1,1,3,2,6,3,
2,3,5,3,4,3,1,5,4,
6,2,3,11,11,12,3,3,4,
2,6,3,2,5,3,5,2,3,
5,11,4,6,2,6,6,3,11,
1,1,4,6,5,5,4,1,3,
4,1,4,4,6,2,4,4,2
