1,6,10,1,6,12,11,1,6,
2,5,10,2,5,12,11,2,5,
3,4,10,3,4,12,11,6,4,
4,3,10,4,3,12,11,4,3,
9,2,10,5,2,12,11,5,2,
6,1,10,6,1,12,11,6,1,
1,6,10,1,6,12,11,1,6,
2,5,10,2,6,12,11,2,5,
3,4,10,3,4,12,11,6,4
